1	0	1	1	1	1	2	1	1	1	1
2	5	0	5	0	5	1	0	5	0	1
1	1	3	1	1	5	1	5	1	5	1
1	0	5	0	5	0	3	0	1	0	1
1	5	3	2	1	2	1	5	1	5	1
1	0	1	0	5	0	3	0	1	0	1
1	5	1	5	1	5	1	1	1	5	1
1	0	5	0	1	0	5	0	1	0	1
4	1	1	1	1	1	1	5	4	5	1
1	0	5	0	5	0	5	0	5	0	6
1	1	1	1	4	2	1	1	1	1	1
