1	1	1	0	2	1	1	4	1	1	1
1	0	5	5	0	5	0	5	0	5	1
1	2	1	1	1	5	2	5	1	5	4
2	0	5	0	1	0	1	0	2	0	1
1	5	1	3	3	5	1	5	1	5	1
1	0	5	0	1	0	5	0	1	0	1
1	3	2	5	1	1	1	2	1	5	1
1	0	5	0	1	0	5	0	1	0	1
1	5	4	2	1	5	2	5	1	5	1
1	0	5	0	5	0	3	0	5	0	6
1	1	1	1	1	1	2	2	1	1	1
